┌───┬───┬───┬───┬───┬───┬───┬───┬───┬───┐
│   │   │   │   │           │           │
├   ┼   ┼   ┼   ┼───┼   ┼───┼───┼   ┼───┤
│       │   │           │   │   │       │
├   ┼───┼   ┼───┼───┼   ┼   ┼   ┼   ┼───┤
│   │       │                       │   │
├   ┼   ┼───┼───┼───┼───┼   ┼───┼   ┼   ┤
│           │                   │       │
├───┼   ┼   ┼   ┼───┼   ┼───┼   ┼───┼───┤
│       │       │   │       │           │
├───┼   ┼───┼   ┼   ┼───┼───┼   ┼───┼───┤
│       │           │       │   │   │   │
├───┼   ┼   ┼───┼   ┼───┼   ┼───┼   ┼   ┤
│   │   │       │       │               │
├   ┼   ┼───┼───┼───┼   ┼───┼   ┼───┼───┤
│               │   │   │       │   │   │
├   ┼───┼───┼───┼   ┼   ┼───┼   ┼   ┼   ┤
│   │                   │   │           │
├   ┼───┼───┼   ┼───┼   ┼   ┼   ┼───┼   ┤
│   │           │               │       │
└───┴───┴───┴───┴───┴───┴───┴───┴───┴───┘
